>Bifidobacterium animalis subsp. lactis AD011~BLA_0036~mazE
ATGACAATGCTGACACTGAGCAAGTGGGGCAATGCGCAGGCGGTTCGCTTGCCCAAGGCGATGCGCGAGC
AGGTCGGGATGCCCGATGATTCGCAGATTGAGGCAACCGTCGAAAACGGTGCGATTGTGCTCAAGCCCGC
GCGGTCGGCAAAGCGCGCGATTCGTGTCGCGAATCTTGCTTCGGTTTTCAAGGATCGCAAGGAGCCCTAC
CGGGCCTGCGAAGATGATTTCGGTGCTCCAGCGGGGAATGAGGGTCTGTGA

>Bifidobacterium animalis subsp. lactis Bl-04~Balac_0044~mazE
ATGACAATGCTGACACTGAGCAAGTGGGGCAATGCGCAGGCGGTTCGCTTGCCCAAGGCGATGCGCGAGC
AGGTCGGGATGCCCGATGATTCGCAGATTGAGGCAACCGTCGAAAACGGTGCGATTGTGCTCAAGCCCGC
GCGGTCGGCAAAGCGCGCGATTCGTGTCGCGAATCTTGCTTCGGTTTTCAAGGATCGCAAGGAGCCCTAC
CGGGCCTGCGAAGATGATTTCGGTGCTCCAGCGGGGAATGAGGGTCTGTGA

>Bifidobacterium animalis subsp. lactis DSM 10140~Balat_0044~mazE
ATGACAATGCTGACACTGAGCAAGTGGGGCAATGCGCAGGCGGTTCGCTTGCCCAAGGCGATGCGCGAGC
AGGTCGGGATGCCCGATGATTCGCAGATTGAGGCAACCGTCGAAAACGGTGCGATTGTGCTCAAGCCCGC
GCGGTCGGCAAAGCGCGCGATTCGTGTCGCGAATCTTGCTTCGGTTTTCAAGGATCGCAAGGAGCCCTAC
CGGGCCTGCGAAGATGATTTCGGTGCTCCAGCGGGGAATGAGGGTCTGTGA

>Bifidobacterium animalis subsp. lactis V9~BalV_0042~mazE
ATGACAATGCTGACACTGAGCAAGTGGGGCAATGCGCAGGCGGTTCGCTTGCCCAAGGCGATGCGCGAGC
AGGTCGGGATGCCCGATGATTCGCAGATTGAGGCAACCGTCGAAAACGGTGCGATTGTGCTCAAGCCCGC
GCGGTCGGCAAAGCGCGCGATTCGTGTCGCGAATCTTGCTTCGGTTTTCAAGGATCGCAAGGAGCCCTAC
CGGGCCTGCGAAGATGATTTCGGTGCTCCAGCGGGGAATGAGGGTCTGTGA

>Bifidobacterium animalis subsp. lactis BLC1~BLC1_0036~mazE
ATGACAATGCTGACACTGAGCAAGTGGGGCAATGCGCAGGCGGTTCGCTTGCCCAAGGCGATGCGCGAGC
AGGTCGGGATGCCCGATGATTCGCAGATTGAGGCAACCGTCGAAAACGGTGCGATTGTGCTCAAGCCCGC
GCGGTCGGCAAAGCGCGCGATTCGTGTCGCGAATCTTGCTTCGGTTTTCAAGGATCGCAAGGAGCCCTAC
CGGGCCTGCGAAGATGATTTCGGTGCTCCAGCGGGGAATGAGGGTCTGTGA

>Bifidobacterium animalis subsp. lactis B420~W7Y_0040~mazE
ATGCTGACACTGAGCAAGTGGGGCAATGCGCAGGCGGTTCGCTTGCCCAAGGCGATGCGCGAGCAGGTCG
GGATGCCCGATGATTCGCAGATTGAGGCAACCGTCGAAAACGGTGCGATTGTGCTCAAGCCCGCGCGGTC
GGCAAAGCGCGCGATTCGTGTCGCGAATCTTGCTTCGGTTTTCAAGGATCGCAAGGAGCCCTACCGGGCC
TGCGAAGATGATTTCGGTGCTCCAGCGGGGAATGAGGGTCTGTGA

>Bifidobacterium animalis subsp. lactis Bi-07~W91_0039~mazE
ATGCTGACACTGAGCAAGTGGGGCAATGCGCAGGCGGTTCGCTTGCCCAAGGCGATGCGCGAGCAGGTCG
GGATGCCCGATGATTCGCAGATTGAGGCAACCGTCGAAAACGGTGCGATTGTGCTCAAGCCCGCGCGGTC
GGCAAAGCGCGCGATTCGTGTCGCGAATCTTGCTTCGGTTTTCAAGGATCGCAAGGAGCCCTACCGGGCC
TGCGAAGATGATTTCGGTGCTCCAGCGGGGAATGAGGGTCTGTGA

>Bifidobacterium animalis subsp. lactis Bl12~Bl12_0036~mazE
ATGACAATGCTGACACTGAGCAAGTGGGGCAATGCGCAGGCGGTTCGCTTGCCCAAGGCGATGCGCGAGC
AGGTCGGGATGCCCGATGATTCGCAGATTGAGGCAACCGTCGAAAACGGTGCGATTGTGCTCAAGCCCGC
GCGGTCGGCAAAGCGCGCGATTCGTGTCGCGAATCTTGCTTCGGTTTTCAAGGATCGCAAGGAGCCCTAC
CGGGCCTGCGAAGATGATTTCGGTGCTCCAGCGGGGAATGAGGGTCTGTGA

>Bifidobacterium animalis RH~EN10_00220~mazE
ATGACAATGCTGACACTGAGCAAGTGGGGCAATGCGCAGGCGGTTCGCTTGCCCAAGGCGATGCGCGAGC
AGGTCGGGATGCCCGATGATTCGCAGATTGAGGCAACCGTCGAAAACGGTGCGATTGTGCTCAAGCCCGC
GCGGTCGGCAAAGCGCGCGATTCGTGTCGCGAATCTTGCTTCGGTTTTCAAGGATCGCAAGGAGCCCTAC
CGGGCCTGCGAAGATGATTTCGGTGCTCCAGCGGGGAATGAGGGTCTGTGA

>Bifidobacterium animalis subsp. lactis KLDS2.0603~U723_00220~mazE
ATGACAATGCTGACACTGAGCAAGTGGGGCAATGCGCAGGCGGTTCGCTTGCCCAAGGCGATGCGCGAGC
AGGTCGGGATGCCCGATGATTCGCAGATTGAGGCAACCGTCGAAAACGGTGCGATTGTGCTCAAGCCCGC
GCGGTCGGCAAAGCGCGCGATTCGTGTCGCGAATCTTGCTTCGGTTTTCAAGGATCGCAAGGAGCCCTAC
CGGGCCTGCGAAGATGATTTCGGTGCTCCAGCGGGGAATGAGGGTCTGTGA

>Bifidobacterium animalis A6~BAA6_0038~mazE
ATGACAATGCTGACACTGAGCAAGTGGGGCAATGCGCAGGCGGTTCGCTTGCCCAAGGCGATGCGCGAGC
AGGTCGGGATGCCCGATGATTCGCAGATTGAGGCAACCGTCGAAAACGGTGCGATTGTGCTCAAGCCCGC
GCGGTCGGCAAAGCGCGCGATTCGTGTCGCGAATCTTGCTTCGGTTTTCAAGGATCGCAAGGAGCCCTAC
CGGGCCTGCGAAGATGATTTCGGTGCTCCAGCGGGGAATGAGGGTCTGTGA

>Bifidobacterium scardovii JCM 12489~BBSC_2533~mazE
ATGGTCAAAGCGACGATCAACAAATGGGGGAATGCCCTCGCGGTGCGCATCCCCAAGGAATTCTGCGAAC
AGCTCAGTCTGCATGCCAGCGATGAGGTGCGGATCACCCTTGAGGAGGATCGTATCGTCATCGAGCCGAT
GGACAGCCCATATACGCTGGAGAATCGGCTCAAGAACTGGAAGGGCGGACGTTACCACTCCCCCGAAATC
GATTGGGGTCCGCCCGTCGGAAAGGAGATGTGGTGA

>Bifidobacterium scardovii JCM 12489~BBSC_0940~mazE
TCATGCGAGCTCCTGACCGACGGGCCGGGCGAAGCCGTCTTCTTCGGGAGCCGGACCATCATAGTCCCGA
AACAGTGCCTGGTAGTCGAGGACATCGATATAGCGTTTTTTGGCCGCCAGAAGGGTGATTTTCCCGTTTT
CCGTATGTATTTCCAGTGAATCGCCTACATGCAGACCGGCTTTTTCCATCGTGTCCTTGGACAAGCGAAC
GCCTTGTCCGTTGCCCCATTTCGTCAATGTGGTGGTGTTCAT
